1111111111111
1E11000000001
11C0011111001
1P001100C0001
1111111111111